Squad,# Pl,Age,MP,Starts,Min,90s,Gls,Ast,G+A,G-PK,PK,PKatt,CrdY,CrdR,Gls,Ast,G+A,G-PK,G+A-PK
Arsenal,27,24.8,38,418,"3,420",38,70,51,121,66,4,7,70,6,1.84,1.34,3.18,1.74,3.08
Aston Villa,32,27.5,38,418,"3,420",38,45,32,77,41,4,6,71,2,1.18,0.84,2.03,1.08,1.92
Birmingham City,26,28,38,418,"3,420",38,37,23,60,35,2,2,59,3,0.97,0.61,1.58,0.92,1.53
Blackburn,29,27.8,38,418,"3,420",38,43,28,71,42,1,2,66,5,1.13,0.74,1.87,1.11,1.84
Blackpool,30,26.8,38,418,"3,420",38,54,29,83,47,7,8,47,2,1.42,0.76,2.18,1.24,2
Bolton,24,28.1,38,418,"3,420",38,50,34,84,46,4,5,70,5,1.32,0.89,2.21,1.21,2.11
Chelsea,24,28.2,38,418,"3,420",38,68,39,107,62,6,8,56,1,1.79,1.03,2.82,1.63,2.66
Everton,24,28.1,38,418,"3,420",38,50,33,83,47,3,4,60,5,1.32,0.87,2.18,1.24,2.11
Fulham,29,29.8,38,418,"3,420",38,48,32,80,46,2,3,52,1,1.26,0.84,2.11,1.21,2.05
Liverpool,30,26.9,38,418,"3,420",38,58,30,88,51,7,8,64,2,1.53,0.79,2.32,1.34,2.13
Manchester City,27,25.4,38,418,"3,420",38,56,35,91,48,8,9,76,5,1.47,0.92,2.39,1.26,2.18
Manchester Utd,29,28.3,38,418,"3,420",38,75,59,134,72,3,5,59,3,1.97,1.55,3.53,1.89,3.45
Newcastle Utd,30,26.3,38,418,"3,420",38,55,35,90,50,5,5,76,2,1.45,0.92,2.37,1.32,2.24
Stoke City,25,27.6,38,418,"3,420",38,44,28,72,41,3,3,70,2,1.16,0.74,1.89,1.08,1.82
Sunderland,31,25,38,418,"3,420",38,41,23,64,37,4,5,64,5,1.08,0.61,1.68,0.97,1.58
Tottenham,28,26.6,38,418,"3,420",38,54,34,88,49,5,5,51,2,1.42,0.89,2.32,1.29,2.18
West Brom,28,26.7,38,418,"3,420",38,52,37,89,48,4,6,55,7,1.37,0.97,2.34,1.26,2.24
West Ham,35,27.9,38,418,"3,420",38,41,21,62,36,5,6,59,1,1.08,0.55,1.63,0.95,1.5
Wigan Athletic,25,25.8,38,418,"3,420",38,37,20,57,35,2,3,69,4,0.97,0.53,1.5,0.92,1.45
Wolves,30,25.8,38,418,"3,420",38,45,29,74,42,3,3,63,2,1.18,0.76,1.95,1.11,1.87